%%%%%%%%%%%%%%%%%%%%
%......%   G%......%
%.%%...%%  %%...%%.%
%.% .%        %. %.%
%.%%.%.%%%%%%.%.%%.%
%........P.........%
%%%%%%%%%%%%%%%%%%%%
